Date,BEDCAP_ICU,VENTCAP_ICU,BEDCAP_OTHER,VENTCAP_OTHER,COVID_NEWICU,COVID_ICU,COVID_NEWOTHER,COVID_OTHER,COVID_VENT,VENTCAP_TOTAL,NONCOVID_ICU,NONCOVID_OTHER,NONCOVID_VENT,COVID_HOSP
2020-04-01,2817,2058,30172,536,0,193,0,327,127,2594,169,6540,106,520
2020-04-02,3681,2089,40123,557,0,293,0,427,204,2646,389,12463,0,720
2020-04-03,3681,2089,40016,557,0,292,0,450,215,2646,384,12369,0,742
2020-04-04,3681,2089,40381,557,0,301,0,498,222,2646,1,6541,0,799
2020-04-05,3681,2089,40721,557,0,324,0,510,227,2646,0,6514,0,834
2020-04-06,4977,2089,56555,557,0,505,0,906,377,2646,368,12324,0,1411
2020-04-07,5049,2089,56576,557,0,527,0,965,396,2646,391,12312,0,1492
2020-04-08,5063,2741,57319,615,0,554,0,1025,426,3356,548,12449,90,1579
2020-04-09,5063,3581,57260,615,0,544,51,1110,438,4196,1426,23405,417,1654
2020-04-10,5063,3581,57028,615,40,498,90,1218,380,4196,1415,23372,404,1716
2020-04-11,5103,3581,57664,615,12,509,125,1266,367,4196,1033,17551,379,1775
2020-04-12,5103,3581,57536,615,13,519,138,1313,382,4196,1030,17673,380,1832
2020-04-13,5103,3581,57533,615,11,500,164,1411,374,4196,1510,24941,396,1911
2020-04-14,5104,3582,57738,617,15,529,181,1426,377,4199,1510,25359,395,1955
2020-04-15,5372,3879,59426,575,11,522,159,1517,382,4454,1681,26036,508,2039
2020-04-16,6556,3883,59954,575,12,527,157,1547,373,4458,1448,27944,454,2074
2020-04-17,6556,3883,59530,575,15,525,213,1614,365,4458,1388,25589,448,2139
2020-04-18,6552,3891,59337,575,2,515,136,1635,363,4466,1368,25819,386,2150
2020-04-19,6552,3876,59367,575,22,534,195,1737,366,4451,1231,21453,424,2271
2020-04-20,6552,3856,59924,621,15,530,170,1813,364,4477,1466,26873,457,2343
2020-04-21,6552,3856,59952,621,13,524,202,1882,362,4477,1587,28912,480,2406
2020-04-22,6570,3856,59638,582,18,516,309,2044,352,4438,1667,26864,527,2560
2020-04-23,6570,3856,59543,582,20,541,214,2091,379,4438,1612,28750,496,2632
2020-04-24,6567,3855,59611,582,13,525,214,2164,380,4437,1524,26726,446,2689
2020-04-25,6567,3855,59707,582,8,525,150,2183,374,4437,1525,27013,428,2708
2020-04-26,6567,3855,59205,582,14,519,166,2226,372,4437,1325,22060,433,2745
2020-04-27,6567,3855,59219,582,12,520,238,2335,374,4437,1579,27377,478,2855
2020-04-28,6566,3854,59710,582,9,525,226,2374,367,4436,1683,29626,507,2899
2020-04-29,6651,3939,62276,590,12,510,247,2444,355,4529,1750,27989,570,2954
2020-04-30,6651,3939,62278,590,11,502,203,2441,350,4529,1620,29814,491,2943
2020-05-01,6651,3939,61728,590,18,497,204,2481,326,4529,1618,27470,467,2978
2020-05-02,6651,3939,61508,590,9,498,182,2493,345,4529,1633,27408,439,2991
2020-05-03,6651,3939,62140,590,12,491,135,2573,340,4529,1323,21563,424,3064
2020-05-04,6651,3939,62377,590,19,490,211,2611,332,4529,1758,30477,477,3101
2020-05-05,6651,3939,62466,590,12,482,191,2638,339,4529,1689,28723,472,3120
2020-05-06,6648,3936,62564,606,15,489,181,2614,321,4542,1814,29296,547,3103
2020-05-07,6651,3939,62693,659,4,466,187,2621,327,4598,1711,30897,444,3087
2020-05-08,6649,3937,62145,661,11,452,177,2587,308,4598,1618,28617,421,3039
2020-05-09,6649,3937,62506,661,13,440,130,2649,285,4598,1646,28640,391,3089
2020-05-10,6649,3937,62567,661,4,429,112,2660,289,4598,1313,22349,417,3089
2020-05-11,6649,3937,62734,661,5,417,148,2667,284,4598,1966,31322,548,3084
2020-05-12,6649,3937,61953,681,11,420,177,2701,288,4618,1722,29157,462,3121
2020-05-13,6651,3939,62758,679,10,408,184,2628,290,4618,1757,29784,448,3036
2020-05-14,6654,3939,62576,683,9,401,148,2663,280,4622,1968,29931,546,3064
2020-05-15,6654,3939,62386,683,37,395,295,2616,269,4622,1756,29192,445,3011
2020-05-16,6654,3939,62502,683,10,381,146,2621,260,4622,1699,28881,424,3002
2020-05-17,5947,3939,52111,683,7,368,118,2582,248,4622,1357,22394,421,2950
2020-05-18,6654,3939,62232,683,13,374,111,2654,250,4622,1711,29374,436,3028
2020-05-19,6654,3939,62628,683,15,371,130,2405,246,4622,1856,32022,504,2776
2020-05-20,6654,3939,62565,683,5,355,115,2354,235,4622,1995,30564,574,2709
2020-05-21,6642,3939,62541,683,11,346,137,2288,235,4622,1872,32615,466,2634
2020-05-22,6642,3939,61998,683,4,336,128,2231,230,4622,1786,29968,468,2567
2020-05-23,6642,3939,61776,683,7,340,72,2185,215,4622,1823,29662,423,2525
2020-05-24,5947,3939,51545,683,14,340,74,2143,223,4622,1453,23190,403,2483
2020-05-25,6583,3880,62721,758,12,344,120,2180,224,4638,2112,33082,598,2524
2020-05-26,6583,3880,62656,758,9,350,98,2123,229,4638,1844,31360,488,2473
2020-05-27,6583,3880,62757,758,1,332,120,2089,207,4638,1905,31693,496,2421
2020-05-28,6583,3880,62748,758,8,319,171,2004,206,4638,1987,33547,502,2323
2020-05-29,6583,3880,62359,758,3,304,91,1949,187,4638,1868,30938,470,2253
2020-05-30,6583,3880,62778,758,7,304,75,1935,201,4638,1797,31195,440,2239
2020-05-31,6583,3880,62785,758,1,302,69,1942,197,4638,1437,24242,419,2244
2020-06-01,6583,3880,62647,758,7,300,83,1917,186,4638,2163,33635,589,2217
2020-06-02,6583,3880,62792,758,5,301,79,1870,193,4638,1925,32003,497,2171
2020-06-03,6583,3880,62701,758,8,284,79,1804,182,4638,1903,31880,477,2088
2020-06-04,6583,3880,62678,758,2,265,54,1674,179,4638,1913,31993,487,1939
2020-06-05,6583,3880,62801,758,2,261,71,1584,179,4638,1907,31490,501,1845
2020-06-06,6583,3880,62787,758,3,262,41,1541,179,4638,1498,23898,442,1803
2020-06-07,6583,3880,62736,758,1,252,52,1555,163,4638,1478,24199,432,1807
2020-06-08,6433,3730,62891,908,4,249,52,1522,165,4638,2192,34006,595,1771
2020-06-09,6433,3730,61710,908,5,252,39,1420,160,4638,1951,31521,523,1672
2020-06-10,6433,3730,62884,908,5,249,57,1363,156,4638,1971,32527,517,1612
2020-06-11,6433,3730,62879,908,3,237,45,1313,149,4638,2001,34305,528,1550
2020-06-12,6433,3730,62636,908,4,227,86,1220,129,4638,1902,31676,459,1447
2020-06-13,6433,3730,62869,908,0,203,32,1193,135,4638,1867,31636,446,1396
2020-06-14,5738,3730,52344,908,3,199,30,1173,114,4638,1478,24498,462,1372
2020-06-15,6429,3730,63091,908,1,193,23,1120,119,4638,2200,34512,598,1313
2020-06-16,6429,3730,63103,908,1,182,39,1046,111,4638,1978,32971,533,1228
2020-06-17,6429,3730,62662,908,0,166,32,983,104,4638,2027,32818,531,1149
2020-06-18,6429,3730,62357,908,1,159,80,910,107,4638,2095,34406,549,1069
2020-06-19,6429,3730,62989,908,1,158,32,823,107,4638,1985,32588,533,981
2020-06-20,6429,3730,62993,908,2,166,31,794,101,4638,1580,24986,466,960
2020-06-21,6429,3730,62905,908,0,151,29,806,100,4638,1554,25193,458,957
2020-06-22,6429,3730,65699,908,1,145,89,796,94,4638,2341,37033,667,941
2020-06-23,6429,3730,65680,908,3,142,32,781,85,4638,2125,35395,592,923
2020-06-24,6429,3730,65646,908,1,135,28,750,85,4638,2078,35474,597,885
2020-06-25,6429,3730,65616,908,5,127,38,744,79,4638,2160,37467,595,871
2020-06-26,6429,3730,65733,908,1,114,38,714,68,4638,2043,34864,536,828
2020-06-27,6429,3730,65095,908,2,110,19,715,68,4638,1565,25015,453,825
2020-06-28,6429,3730,65334,908,3,107,27,698,65,4638,1604,25547,473,805
2020-06-29,6429,3730,65286,908,3,95,25,688,61,4638,2411,37566,647,783
2020-06-30,6429,3730,65562,908,2,91,30,622,52,4638,2099,35779,572,713
2020-07-01,6429,3730,65450,908,3,87,28,617,45,4638,1567,25752,441,704
2020-07-02,6429,3730,65559,908,3,87,20,591,48,4638,2146,37649,542,678
2020-07-03,6429,3730,65406,908,0,81,15,576,48,4638,2036,35239,530,657
2020-07-04,6429,3730,65488,908,0,79,20,566,46,4638,1924,33299,420,645
2020-07-05,6429,3730,65521,908,0,73,21,572,43,4638,1624,25785,428,645
2020-07-06,6488,3789,65049,849,0,71,15,530,41,4638,2461,38062,627,601
2020-07-07,6488,3789,65456,849,3,73,23,508,43,4638,2225,36596,555,581
2020-07-08,6488,3789,65441,849,1,68,25,476,36,4638,2180,37844,603,544
2020-07-09,6488,3789,65398,849,1,72,54,492,36,4638,2263,38611,595,564
2020-07-10,6488,3789,65370,849,0,67,22,469,29,4638,2130,35989,561,536
2020-07-11,6488,3789,65356,849,1,66,16,478,30,4638,1989,33828,435,544
2020-07-12,6488,3789,65394,849,1,68,25,483,30,4638,1649,26296,419,551
2020-07-13,6488,3789,65445,849,2,71,15,452,34,4638,2416,38729,528,523
2020-07-14,6488,3789,65453,849,1,65,25,446,35,4638,2188,36927,546,511
2020-07-15,6488,3789,65037,849,2,62,20,445,33,4638,2164,36657,574,507
2020-07-16,6488,3789,65056,849,0,67,29,429,32,4638,2257,38703,563,496
2020-07-17,6488,3789,64278,849,1,65,26,427,32,4638,2145,35503,524,492
2020-07-18,6488,3789,65187,849,2,67,20,441,34,4638,1635,26097,451,508
2020-07-19,6488,3789,65438,849,1,71,34,442,35,4638,1619,26408,410,513
2020-07-20,6488,3789,65378,849,2,72,20,455,42,4638,2403,38863,653,527
2020-07-21,6488,3789,65380,849,3,74,25,472,38,4638,2128,36944,549,546
2020-07-22,6488,3789,65397,849,0,73,40,451,41,4638,2156,36956,524,524
2020-07-23,6488,3789,65142,849,3,67,13,398,42,4638,2221,39041,551,465
2020-07-24,6488,3789,65307,849,0,65,13,377,42,4638,2145,36289,554,442
2020-07-25,6488,3789,65288,849,0,63,30,363,43,4638,1606,26219,405,426
2020-07-26,6488,3789,65216,849,0,62,40,376,40,4638,1609,26614,408,438
2020-07-27,6488,3789,65405,849,1,61,26,362,37,4638,2495,38810,652,423
2020-07-28,6488,3789,65345,849,1,62,21,341,37,4638,2191,37054,518,403
2020-07-29,6488,3789,65345,849,5,71,59,344,37,4638,2216,37030,530,415
2020-07-30,6488,3789,66676,849,2,69,28,313,40,4638,2272,38871,548,382
2020-07-31,6488,3789,65332,849,1,71,14,296,37,4638,2055,34347,455,367
2020-08-01,6488,3789,65185,849,0,74,11,290,39,4638,1606,26032,443,364
2020-08-02,6488,3789,65161,849,2,76,18,287,38,4638,1595,26167,433,363
2020-08-03,6488,3789,64898,849,2,84,15,263,40,4638,1725,28486,451,347
2020-08-04,6488,3789,65017,849,2,84,20,263,44,4638,2383,36736,632,347
2020-08-05,6488,3789,65411,849,1,85,14,245,42,4638,2169,37232,533,330
2020-08-06,6488,3789,65448,849,1,81,28,218,38,4638,2251,39287,545,299
2020-08-07,6488,3789,65326,849,3,77,17,227,36,4638,2157,36584,527,304
2020-08-08,6488,3789,65215,849,2,75,8,224,38,4638,1621,26327,436,299
2020-08-09,6488,3789,65229,849,0,70,10,234,41,4638,1636,26603,411,304
2020-08-10,6512,3813,65456,825,2,67,9,214,35,4638,2510,39229,684,281
2020-08-11,6512,3813,65374,825,3,66,9,204,32,4638,2199,37591,542,270
2020-08-12,6512,3813,65497,825,2,69,24,198,32,4638,2175,37797,542,267
2020-08-13,6512,3813,65320,825,2,67,21,232,30,4638,2213,39086,581,299
2020-08-14,6512,3813,65386,825,0,66,15,201,31,4638,2149,36839,550,267
2020-08-15,6512,3813,65353,825,1,66,16,197,30,4638,1642,26572,450,263
2020-08-16,6512,3813,65004,825,1,61,5,202,30,4638,1663,26560,462,263
2020-08-17,6512,3813,65521,825,4,63,13,196,29,4638,2509,39566,679,259
2020-08-18,6512,3813,65099,827,0,63,10,193,24,4640,2231,37513,567,256
2020-08-19,6512,3813,65260,827,0,62,41,193,23,4640,2217,37691,585,255
2020-08-20,6512,3813,65085,827,0,56,9,190,22,4640,2310,39521,564,246
2020-08-21,6512,3813,65404,827,0,50,10,190,20,4640,2193,37182,520,240
2020-08-22,6512,3813,65043,827,0,45,7,185,20,4640,1642,26444,399,230
2020-08-23,6512,3813,65487,827,0,43,12,183,22,4640,1671,27149,419,226
2020-08-24,6512,3813,65425,857,0,42,17,196,22,4670,2542,39581,692,238
2020-08-25,6512,3813,65459,857,0,45,13,197,21,4670,2254,37980,555,242
2020-08-26,6512,3813,64940,857,3,50,19,211,22,4670,2252,37567,550,261
2020-08-27,6512,3813,65059,857,1,52,14,200,24,4670,1897,31558,581,252
2020-08-28,6512,3813,65320,857,1,52,10,197,16,4670,1781,29049,455,249
2020-08-29,6512,3813,65155,857,1,54,12,190,23,4670,1711,26713,463,244
2020-08-30,6512,3813,65401,857,2,58,17,203,21,4670,1680,27060,463,261
2020-08-31,6512,3813,65406,827,3,60,10,208,17,4640,2468,39562,672,268
2020-09-01,6512,3813,65525,827,1,56,18,213,23,4640,2202,37811,549,269
2020-09-02,6512,3813,65508,827,1,58,9,206,28,4640,2182,37705,556,264
2020-09-03,6512,3813,65418,827,1,55,17,208,25,4640,2270,39599,589,263
2020-09-04,6512,3813,65483,827,1,58,11,190,27,4640,2174,36943,564,248
2020-09-05,5817,3813,54784,827,2,49,18,177,21,4640,1680,26502,443,226
2020-09-06,5817,3813,54966,827,1,50,10,177,21,4640,1679,26623,458,227
2020-09-07,5817,3813,55006,827,1,45,10,181,21,4640,1797,29230,491,226
2020-09-08,6512,3813,65525,827,1,52,23,210,25,4640,2434,37625,713,262
2020-09-09,6512,3813,65536,827,0,52,15,217,26,4640,2277,37930,595,269
2020-09-10,6512,3813,65495,827,0,53,21,217,27,4640,2381,40056,620,270
2020-09-11,6512,3813,65395,827,5,48,20,229,27,4640,2254,37330,592,277
2020-09-12,6512,3813,65388,827,2,54,16,229,29,4640,1707,27106,470,283
2020-09-13,6512,3813,65067,827,0,55,14,225,28,4640,1716,26881,452,280
2020-09-14,6512,3813,65152,826,6,68,23,231,31,4639,2610,39918,692,299
2020-09-15,6512,3813,65523,826,3,74,18,233,34,4639,2292,38414,570,307
2020-09-16,6484,3794,65701,845,5,84,25,236,33,4639,2288,38757,557,320
2020-09-17,6484,3794,65711,845,0,80,26,248,34,4639,2367,40917,607,328
2020-09-18,6484,3794,65643,845,2,82,16,249,35,4639,2253,37988,602,331
2020-09-19,6484,3794,65570,845,2,87,19,254,38,4639,1730,27594,496,341
2020-09-20,6484,3794,65609,845,3,88,36,281,43,4639,1705,27774,498,369
2020-09-21,6484,3794,65609,845,5,86,41,313,46,4639,2577,40329,705,399
2020-09-22,6484,3794,65649,845,2,93,24,327,42,4639,2299,38566,553,420
2020-09-23,6484,3794,65651,845,4,94,28,340,43,4639,2321,38573,604,434
2020-09-24,6484,3794,65492,866,6,100,38,362,45,4660,2378,40933,620,462
2020-09-25,6484,3794,65614,866,10,115,53,382,44,4660,2274,38392,596,497
2020-09-26,6484,3794,65140,866,1,114,47,396,46,4660,1734,27511,438,510
2020-09-27,6484,3794,64954,866,1,110,25,405,48,4660,1731,27508,442,515
2020-09-28,6484,3794,65293,866,6,114,57,448,46,4660,2585,40587,744,562
2020-09-29,6484,3794,65722,866,3,120,58,464,46,4660,2362,39071,585,584
2020-09-30,6484,3794,65643,866,8,125,56,485,47,4660,2260,39286,542,610
2020-10-01,6484,3794,65342,866,8,129,56,479,50,4660,2372,41061,620,608
2020-10-02,6484,3794,65451,866,9,141,66,496,55,4660,2223,38433,581,637
2020-10-03,6484,3794,65419,866,7,147,44,508,57,4660,1697,27746,465,655
2020-10-04,6484,3794,65419,866,4,141,61,557,55,4660,1744,27730,447,698
2020-10-05,6484,3794,65754,866,12,146,58,589,61,4660,2554,40489,699,735
2020-10-06,6484,3794,65436,866,6,143,68,621,62,4660,2280,38411,586,764
2020-10-07,4988,2295,65704,866,13,151,71,670,66,3161,2286,38887,647,821
2020-10-08,4988,2295,65749,866,3,150,76,670,64,3161,2346,40937,631,820
2020-10-09,4988,2295,65391,866,4,160,90,664,70,3161,2085,35571,519,824
2020-10-10,4988,2295,63512,866,3,161,58,651,72,3161,1655,25745,478,812
2020-10-11,4988,2295,64386,866,7,170,68,693,71,3161,1649,26216,464,863
2020-10-12,4988,2295,64199,866,14,186,46,688,76,3161,1761,28415,482,874
2020-10-13,4988,2295,65556,866,3,191,77,740,88,3161,2344,37940,668,931
2020-10-14,4990,2300,65360,866,9,191,61,756,95,3166,2234,38520,596,947
2020-10-15,4990,2300,65582,866,7,198,63,781,98,3166,2320,40770,614,979
2020-10-16,4990,2298,65515,866,4,206,66,754,102,3164,2213,38027,611,960
2020-10-17,4990,2300,65505,866,4,209,71,771,101,3166,1731,27827,473,980
2020-10-18,5033,2337,65413,866,7,209,64,790,100,3203,1742,27925,472,999
2020-10-19,5033,2337,65541,866,12,218,80,808,108,3203,2518,40681,724,1026
2020-10-20,5033,2337,65525,866,4,210,88,828,116,3203,2258,38885,632,1038
2020-10-21,5033,2337,65459,866,5,225,63,809,122,3203,2272,38907,629,1034
2020-10-22,5033,2337,65493,866,2,228,77,828,120,3203,2310,40833,653,1056
2020-10-23,5033,2337,64465,922,6,228,73,841,124,3259,2193,37203,642,1069
2020-10-24,5033,2337,64914,922,6,233,101,870,124,3259,1722,27222,494,1103
2020-10-25,5033,2337,64896,922,3,232,49,889,121,3259,1714,27534,489,1121
2020-10-26,5033,2337,64930,922,8,229,71,922,123,3259,2530,40042,713,1151
2020-10-27,5033,2337,65257,922,4,228,86,952,124,3259,2278,38305,629,1180
2020-10-28,5033,2337,65454,922,2,223,72,943,119,3259,2265,38734,644,1166
2020-10-29,5033,2337,65446,922,3,227,79,969,117,3259,2381,41146,638,1196
2020-10-30,5033,2337,65362,922,8,228,75,968,122,3259,2217,37739,634,1196
2020-10-31,5033,2337,65366,922,3,224,55,990,114,3259,1725,27174,506,1214
2020-11-01,5033,2337,64996,922,5,227,59,1032,112,3259,1769,26997,543,1259
2020-11-02,5019,2323,65026,922,7,229,109,1094,121,3245,2358,39708,655,1323
2020-11-03,5019,2323,64689,922,6,235,93,1114,126,3245,2309,39455,688,1349
2020-11-04,5066,2376,65621,922,5,252,99,1102,131,3298,2301,40252,686,1354
2020-11-05,5066,2376,63977,922,3,242,104,1149,127,3298,2419,41058,656,1391
2020-11-06,5077,2387,65500,922,6,254,97,1131,132,3309,2180,37530,591,1385
2020-11-07,5077,2387,64989,922,5,259,103,1136,130,3309,2112,35340,521,1395
2020-11-08,5091,2401,65477,922,11,271,108,1218,137,3323,1728,27478,507,1489
2020-11-09,5093,2956,65534,1227,15,279,110,1249,135,4183,2389,42256,835,1528
2020-11-10,5172,2960,65986,1227,21,300,172,1323,148,4187,1956,31611,696,1623
2020-11-11,5172,2960,66610,1227,7,320,131,1353,156,4187,2146,36629,688,1673
2020-11-12,5172,2960,66579,1227,11,333,145,1415,172,4187,2344,42458,765,1748
2020-11-13,5176,2974,66332,1227,8,342,157,1429,177,4201,2239,39599,748,1771
2020-11-14,5176,2974,66577,1227,9,363,140,1439,178,4201,2136,37164,547,1802
2020-11-15,5176,2974,66601,1227,14,377,115,1458,180,4201,1759,29065,512,1835
2020-11-16,5188,2986,66405,1227,19,402,175,1532,200,4213,2313,41802,668,1934
2020-11-17,5188,2986,66719,1227,9,403,161,1577,210,4213,2282,40517,790,1980
2020-11-18,5188,2986,66719,1227,9,423,157,1570,217,4213,2264,40146,764,1993
2020-11-19,5188,2987,66531,1227,13,419,169,1540,229,4214,2306,42063,771,1959
2020-11-20,5193,2987,62097,1227,11,420,189,1584,224,4214,2190,36208,691,2004
2020-11-21,5152,2988,62115,1227,13,422,170,1646,225,4215,2096,33921,498,2068
2020-11-22,5194,2988,61694,1227,17,443,172,1661,231,4215,1689,28338,501,2104
2020-11-23,5197,2991,61372,1227,14,450,177,1761,236,4218,2264,38268,692,2211
2020-11-24,5173,3005,58909,1213,9,451,188,1804,239,4218,2195,34441,741,2255
2020-11-25,5175,3009,59311,1213,16,442,195,1845,248,4222,2234,34525,734,2287
2020-11-26,5177,3009,59104,1214,25,455,203,1994,241,4223,2316,36192,779,2449
2020-11-27,5182,3013,59353,1215,26,465,196,2035,232,4228,2155,33730,757,2500
2020-11-28,5183,3014,59215,1215,13,470,161,2073,228,4229,2066,26768,526,2543
2020-11-29,5183,3014,59321,1215,17,487,150,2111,247,4229,1720,26553,567,2598
2020-11-30,5190,3014,59973,1214,16,519,191,2197,254,4228,2252,36130,772,2716
2020-12-01,5189,3013,59507,1214,28,525,192,2253,260,4227,2173,34442,769,2778
2020-12-02,5189,3013,59178,1214,31,544,241,2286,263,4227,2119,33889,757,2830
2020-12-03,5189,3013,59487,1214,20,556,184,2348,262,4227,2189,36161,750,2904
2020-12-04,5242,3047,59631,1225,14,556,218,2409,259,4272,2002,31656,590,2965
2020-12-05,5242,3047,59577,1225,21,562,194,2465,254,4272,1686,26332,539,3027
2020-12-06,5242,3047,59612,1225,20,573,162,2558,267,4272,1671,26318,511,3131
2020-12-07,5242,3047,59517,1225,16,589,191,2605,283,4272,2197,35342,770,3194
2020-12-08,5242,3047,59804,945,16,602,205,2577,266,3992,2151,33898,787,3179
2020-12-09,5242,3047,59532,945,13,606,192,2525,280,3992,2163,33718,775,3131
2020-12-10,5242,3047,59451,945,39,646,242,2582,274,3992,2270,35695,782,3228
2020-12-11,5241,3042,59638,944,20,650,194,2557,300,3986,2143,33065,656,3207
2020-12-12,5241,3042,59226,944,16,659,201,2577,298,3986,2012,30856,528,3236
2020-12-13,5241,3042,59706,944,13,651,191,2692,311,3986,1681,26114,533,3343
2020-12-14,5241,3042,59468,944,20,659,283,2826,322,3986,2236,34946,787,3485
2020-12-15,5241,3042,59613,944,19,681,216,2767,333,3986,2150,33682,740,3448
2020-12-16,5241,3042,59143,944,27,697,275,2771,360,3986,2126,32977,740,3468
2020-12-17,5241,3042,59707,944,16,696,236,2778,354,3986,2221,35126,782,3474
2020-12-18,5241,3053,59781,937,20,703,227,2754,338,3990,2057,30642,656,3457
2020-12-19,5241,3053,59515,937,20,706,203,2799,342,3990,1984,30133,508,3505
2020-12-20,5241,3053,59687,937,15,701,236,2936,341,3990,1639,25149,511,3637
2020-12-21,5241,3053,59731,937,12,701,238,2956,356,3990,2150,33644,719,3657
2020-12-22,5241,3053,59824,937,23,702,249,2924,370,3990,2047,31551,738,3626
2020-12-23,5241,3053,59751,937,16,699,255,2888,364,3990,1978,30443,723,3587
2020-12-24,5241,3056,58864,937,7,694,157,2711,337,3993,1821,27000,608,3405
2020-12-25,5241,3056,59396,937,9,700,138,2844,363,3993,1787,26893,486,3544
2020-12-26,5241,3056,60014,937,28,712,329,3083,370,3993,1826,27838,506,3795
2020-12-27,5241,3056,60095,937,18,735,237,3153,384,3993,1525,23870,519,3888
2020-12-28,5241,3056,59302,937,10,744,190,3281,380,3993,1994,30896,566,4025
2020-12-29,5241,3056,59685,937,35,776,412,3492,378,3993,1987,31349,689,4268
2020-12-30,5241,3056,59388,937,14,793,259,3488,375,3993,2008,31459,689,4281
2020-12-31,5241,3053,59108,936,8,787,190,3431,385,3989,1921,30804,685,4218
2021-01-01,5241,3053,59468,936,11,778,189,3398,386,3989,1833,29432,485,4176
2021-01-02,5241,3053,59513,936,35,793,348,3595,392,3989,1850,29520,489,4388
2021-01-03,5241,3053,59449,936,21,804,293,3712,373,3989,1543,24725,449,4516
2021-01-04,5241,3053,59839,936,24,839,343,3754,430,3989,2071,35557,740,4593
2021-01-05,5241,3053,59945,936,31,852,352,3817,447,3989,2045,34245,728,4669
2021-01-06,5241,3053,60020,936,20,848,292,3813,440,3989,2124,33980,713,4661
2021-01-07,5241,3053,60014,936,23,848,322,3830,449,3989,2157,36153,722,4678
2021-01-08,5241,3047,60008,937,17,860,269,3777,450,3984,1934,31649,652,4637
2021-01-09,5241,3047,59919,937,16,856,303,3832,468,3984,1557,26040,517,4688
2021-01-10,5241,3047,59927,937,20,865,268,3996,471,3984,1588,26109,502,4861
2021-01-11,5241,3047,59981,937,29,881,306,4049,470,3984,2111,35692,732,4930
2021-01-12,5242,3047,59823,937,21,888,321,4032,494,3984,2093,33677,729,4920
2021-01-13,5242,3047,59989,948,37,903,322,4025,500,3995,2069,33602,715,4928
2021-01-14,5242,3047,59910,948,21,894,309,3977,491,3995,2078,33937,700,4871
2021-01-15,5242,3055,59901,951,17,889,309,3889,487,4006,2012,31204,540,4778
2021-01-16,5242,3056,59778,951,16,881,220,3838,492,4007,1938,25638,503,4719
2021-01-17,5242,3056,59940,951,16,878,246,3901,504,4007,1607,26013,528,4779
2021-01-18,5256,3058,59998,951,15,873,260,3874,496,4009,2113,35608,730,4747
2021-01-19,5256,3058,59871,951,20,876,312,3757,498,4009,2023,33728,729,4633
2021-01-20,5256,3058,59990,951,24,860,298,3704,497,4009,2040,33754,701,4564
2021-01-21,5256,3058,59533,951,14,849,254,3623,498,4009,2127,35482,722,4472
2021-01-22,5256,3059,59910,954,24,876,261,3527,505,4013,1952,31454,558,4403
2021-01-23,5257,3059,59766,954,21,873,174,3399,499,4013,1919,26071,521,4272
2021-01-24,5257,3059,59869,954,21,873,194,3413,479,4013,1567,26033,482,4286
2021-01-25,5251,3053,59960,954,19,850,230,3354,497,4007,2089,35486,675,4204
2021-01-26,5250,3053,59738,954,23,855,212,3225,486,4007,2065,33762,696,4080
2021-01-27,5250,3053,59685,954,14,833,234,3166,480,4007,2033,33626,716,3999
2021-01-28,5250,3053,59701,954,17,843,212,3088,479,4007,2034,32842,715,3931
2021-01-29,5256,3064,59709,952,14,812,205,2925,426,4016,1929,31477,522,3737
2021-01-30,5242,3064,59825,952,10,806,164,2896,469,4016,1575,31248,500,3702
2021-01-31,5242,3064,59765,952,9,799,151,2883,466,4016,1551,26169,491,3682
2021-02-01,5246,3065,59420,952,9,771,169,2735,458,4017,2040,33967,641,3506
2021-02-02,5246,3065,59947,952,12,759,266,2805,451,4017,2105,34263,722,3564
2021-02-03,5483,3249,59373,952,14,736,176,2696,430,4201,2111,33553,737,3432
2021-02-04,5483,3249,59511,952,5,727,175,2589,415,4201,2230,36041,720,3316
2021-02-05,5514,3246,59593,955,11,709,176,2473,413,4201,2142,33555,628,3182
2021-02-06,5483,3246,59576,955,12,717,133,2403,414,4201,1660,26124,524,3120
2021-02-07,5510,3275,59762,955,13,712,168,2445,407,4230,1678,26139,487,3157
2021-02-08,5501,3260,59739,955,9,678,133,2370,392,4215,2213,35825,724,3048
2021-02-09,5501,3260,59966,955,13,668,144,2301,388,4215,2135,34297,721,2969
2021-02-10,5501,3260,59894,955,13,644,132,2170,372,4215,2154,34241,722,2814
2021-02-11,5501,3260,59887,955,10,623,138,2084,357,4215,2183,34464,661,2707
2021-02-12,5501,3259,59595,959,6,614,129,2007,359,4218,2072,31655,701,2621
2021-02-13,5501,3259,59658,959,7,601,114,2004,353,4218,1687,31332,573,2605
2021-02-14,5501,3259,59667,959,13,606,123,1997,348,4218,1656,26079,573,2603
2021-02-15,5501,3259,59318,959,9,598,100,1922,349,4218,1803,33569,555,2520
2021-02-16,5501,3259,59819,959,17,606,112,1959,354,4218,2143,34260,744,2565
2021-02-17,5501,3259,59732,959,17,576,149,1891,330,4218,2162,34531,761,2467
2021-02-18,5501,3259,59920,959,10,562,153,1883,320,4218,2272,36694,784,2445
2021-02-19,5501,3260,59919,968,12,543,136,1831,312,4228,2165,34016,751,2374
2021-02-20,5365,3149,59809,968,10,563,125,1786,315,4117,2046,32087,506,2349
2021-02-21,5365,3149,59868,968,11,566,134,1846,317,4117,1666,26610,521,2412
2021-02-22,5365,3149,59953,968,12,567,122,1794,323,4117,2253,36791,734,2361
2021-02-23,5365,3149,59964,1056,14,587,143,1769,318,4205,2231,35039,753,2356
2021-02-24,5365,3149,59938,1056,17,573,135,1715,320,4205,2171,35051,733,2288
2021-02-25,5365,3149,60021,1056,15,570,134,1690,318,4205,2305,37171,799,2260
2021-02-26,5364,3148,59976,1055,10,554,145,1637,306,4203,2107,32510,705,2191
2021-02-27,5364,3148,59358,1055,13,569,113,1634,303,4203,2091,31703,541,2203
2021-02-28,5364,3148,59924,1055,12,564,114,1645,293,4203,1701,26950,543,2209
2021-03-01,5364,3148,60034,1055,14,577,131,1608,308,4203,2197,35101,681,2185
2021-03-02,5364,3148,60056,1055,15,560,150,1592,310,4203,2210,35087,759,2152
2021-03-03,5364,3148,59952,1080,11,558,131,1593,306,4228,2182,34983,777,2151
2021-03-04,5364,3148,60056,1080,13,547,134,1566,305,4228,2290,37059,786,2113
2021-03-05,5364,3148,59956,1078,11,542,135,1556,306,4226,2199,34201,771,2098
2021-03-06,5373,3157,59898,1078,10,534,116,1563,303,4235,2040,32113,548,2097
2021-03-07,5373,3157,59920,1078,10,544,111,1596,306,4235,1660,26820,529,2140
2021-03-08,5373,3157,59991,1078,16,554,133,1521,301,4235,2265,36878,709,2075
2021-03-09,5373,3157,60009,1078,11,551,150,1589,302,4235,2200,35003,740,2140
2021-03-10,5373,3157,59945,1078,12,546,141,1556,307,4235,2224,35089,775,2102
2021-03-11,5373,3157,59935,1078,6,546,141,1571,323,4235,2305,37052,770,2117
2021-03-12,5373,3157,59903,1078,9,537,158,1556,312,4235,2156,34223,731,2093
2021-03-13,5403,3193,59694,1079,8,540,294,1594,320,4272,2039,31885,511,2134
2021-03-14,5403,3193,59580,1079,7,562,147,1651,319,4272,1692,26526,504,2213
2021-03-15,5403,3193,59935,1079,7,555,136,1629,320,4272,2114,35073,701,2184
2021-03-16,5408,3198,59844,1079,26,590,168,1602,315,4277,2143,34722,773,2192
2021-03-17,5408,3198,59869,1079,10,584,163,1637,315,4277,2163,34610,749,2221
2021-03-18,5408,3198,59763,1079,18,588,172,1643,297,4277,2268,36595,790,2231
2021-03-19,5404,3198,59534,1080,15,580,199,1681,319,4278,2139,33540,774,2261
2021-03-20,5404,3198,59796,1080,12,584,123,1716,318,4278,2014,31471,552,2300
2021-03-21,5404,3198,59752,1080,14,591,138,1722,322,4278,1686,26323,525,2313
2021-03-22,5404,3198,59862,1080,9,622,220,1790,337,4278,2229,36601,725,2412
2021-03-23,5404,3198,59931,1080,14,638,191,1777,361,4278,2125,34718,721,2415
2021-03-24,5404,3198,59824,1080,14,639,179,1779,354,4278,2152,34688,702,2418
2021-03-25,5419,3198,59906,1080,8,665,197,1832,362,4278,2287,36833,719,2497
2021-03-26,5419,3198,59636,1083,14,675,151,1807,341,4281,1981,31943,511,2482
2021-03-27,5419,3198,59751,1083,13,675,133,1839,365,4281,1972,31749,496,2514
2021-03-28,5419,3198,59734,1083,12,693,158,1891,382,4281,1614,26638,505,2584
2021-03-29,5419,3198,59873,1083,19,705,177,1946,397,4281,2165,36617,698,2651
2021-03-30,5419,3198,59807,1083,9,712,195,1943,399,4281,2090,34556,702,2655
2021-03-31,5419,3198,59661,1083,16,717,222,1974,390,4281,2067,34380,619,2691
2021-04-01,5419,3198,59555,1083,17,722,228,1984,401,4281,2001,31746,640,2706
2021-04-02,5419,3207,59579,1092,13,754,220,2047,393,4299,1918,31062,513,2801
2021-04-03,5425,3207,59518,1092,16,791,222,2088,399,4299,1891,30885,456,2879
2021-04-04,5425,3207,59528,1092,17,819,192,2142,431,4299,1549,25852,498,2961
2021-04-05,5425,3207,59917,1092,35,859,243,2230,463,4299,2003,35724,560,3089
2021-04-06,5429,3211,60011,1092,15,856,270,2286,476,4303,1992,34060,651,3142
2021-04-07,5430,3212,60002,1092,26,897,284,2308,495,4304,1969,34417,684,3205
2021-04-08,5430,3212,60042,1092,20,919,284,2350,522,4304,2081,36826,675,3269
2021-04-09,5430,3219,59773,1088,17,960,307,2413,561,4307,1871,31801,638,3373
2021-04-10,5411,3200,59216,1088,30,996,309,2539,551,4288,1845,31150,507,3535
2021-04-11,5411,3200,59923,1088,24,1014,350,2654,589,4288,1494,26258,487,3668
2021-04-12,5411,3200,60028,1107,28,1028,342,2750,599,4307,2026,35809,701,3778
2021-04-13,5411,3200,60091,1107,23,1045,330,2838,627,4307,1918,33751,709,3883
2021-04-14,5411,3200,59797,1107,34,1070,327,2852,634,4307,1883,33585,693,3922
2021-04-15,5416,3200,60012,1107,35,1125,366,2913,674,4307,1943,35737,698,4038
2021-04-16,5416,3197,59968,1107,18,1154,411,3042,689,4304,1772,30850,637,4196
2021-04-17,5409,3190,59816,1107,24,1186,345,3103,700,4297,1719,30655,479,4289
2021-04-18,5417,3198,59963,1107,21,1216,333,3190,719,4305,1690,30762,478,4406
2021-04-19,5417,3198,59992,1107,16,1215,371,3205,747,4305,1866,34618,682,4420
2021-04-20,5417,3198,60027,1106,34,1261,414,3257,781,4304,1810,32925,694,4518
2021-04-21,5419,3198,59144,1106,30,1293,369,3207,803,4304,1779,32382,660,4500
2021-04-22,5422,3198,59755,1106,17,1308,321,3177,795,4304,1826,34473,675,4485
2021-04-23,5423,3219,59579,1102,20,1334,337,3124,797,4321,1669,29875,586,4458
2021-04-24,5460,3237,59588,1102,17,1342,330,3180,798,4339,1675,29968,442,4522
2021-04-25,5460,3237,59583,1102,27,1367,297,3195,801,4339,1618,30252,446,4562
2021-04-26,5460,3237,59912,1102,19,1365,331,3181,788,4339,1807,34528,663,4546
2021-04-27,5460,3237,59904,1102,20,1363,335,3153,795,4339,1759,32489,670,4516
2021-04-28,5409,3237,60166,1102,18,1380,343,3047,811,4339,1739,32330,658,4427
2021-04-29,5399,3237,60017,1102,21,1381,331,3001,821,4339,1822,34510,664,4382
2021-04-30,5398,3281,60067,1106,16,1386,336,2949,816,4387,1646,29985,574,4335
2021-05-01,5614,3493,59837,1106,22,1387,312,3000,803,4599,1606,30024,452,4387
2021-05-02,5614,3493,59849,1106,18,1381,291,3058,789,4599,1624,30298,444,4439
2021-05-03,5614,3493,59947,1106,22,1384,305,2946,799,4599,1845,34429,570,4330
2021-05-04,5614,3493,59955,1106,17,1375,317,2851,816,4599,1793,32462,708,4226
2021-05-05,5618,3498,59984,1106,16,1346,283,2819,812,4604,1754,32397,683,4165
2021-05-06,5619,3499,59951,1106,25,1320,270,2725,815,4605,1867,34560,722,4045
2021-05-07,5619,3508,59462,1110,23,1310,296,2648,791,4618,1695,29611,601,3958
2021-05-08,5619,3508,59365,1110,12,1300,266,2639,776,4618,1395,24496,467,3939
2021-05-09,5619,3508,59407,1110,13,1287,236,2709,746,4618,1417,24987,455,3996
2021-05-10,5627,3516,59906,1110,22,1281,234,2594,753,4626,1908,34484,715,3875
2021-05-11,5627,3516,59734,1110,23,1259,258,2632,744,4626,1815,32614,715,3891
2021-05-12,5627,3516,59853,1110,12,1262,218,2564,765,4626,1806,30743,695,3826
2021-05-13,5627,3516,59858,1110,21,1268,251,2543,772,4626,1896,32684,712,3811
2021-05-14,5624,3520,59783,1110,13,1269,178,2350,759,4630,1705,28349,603,3619
2021-05-15,5624,3520,59427,1110,12,1278,190,2361,756,4630,1367,22901,475,3639
2021-05-16,5624,3520,59803,1110,9,1268,179,2430,731,4630,1400,23390,469,3698
2021-05-17,5624,3520,59749,1110,10,1247,167,2314,751,4630,1934,33210,756,3561
2021-05-18,5624,3520,59826,1110,11,1195,220,2278,705,4630,1905,32987,782,3473
2021-05-19,5626,3522,59732,1110,17,1163,215,2230,656,4632,1963,32996,753,3393
2021-05-20,5626,3522,59788,1110,7,1140,209,2137,673,4632,2075,34990,801,3277
2021-05-21,5629,3529,59772,1112,23,1116,202,2144,658,4641,1882,30154,686,3260
2021-05-22,5629,3529,59719,1112,14,1088,169,2035,627,4641,1852,30046,504,3123
2021-05-23,5629,3529,59685,1112,6,1079,197,2076,612,4641,1847,30280,522,3155
2021-05-24,5629,3529,59356,1112,15,1073,177,2017,619,4641,1956,32483,569,3090
2021-05-25,5629,3529,59818,1112,27,1060,198,1944,599,4641,1984,33351,794,3004
2021-05-26,5629,3528,59786,1108,21,1028,172,1892,594,4636,2015,33556,788,2920
2021-05-27,5629,3528,59315,1108,15,1000,155,1782,585,4636,2101,35686,821,2782
2021-05-28,5631,3528,59641,1108,20,960,151,1677,557,4636,1917,30767,719,2637
2021-05-29,5631,3528,60305,1108,7,940,108,1641,533,4636,1486,23829,500,2581
2021-05-30,5631,3528,59274,1108,19,939,121,1588,511,4636,1915,25479,546,2527
2021-05-31,5631,3528,59450,1108,13,896,120,1502,509,4636,2134,35528,790,2398
2021-06-01,5631,3528,59431,1108,13,869,118,1482,518,4636,2070,33474,766,2351
2021-06-02,5631,3528,59383,1108,10,810,116,1414,476,4636,2062,33258,791,2224
2021-06-03,5636,3533,59549,1108,8,771,122,1328,473,4641,2071,33302,788,2099
2021-06-04,5636,3528,59433,1107,6,743,112,1293,464,4635,1990,30670,711,2036
2021-06-05,5636,3528,60872,1107,11,728,116,1297,450,4635,1574,30453,514,2025
2021-06-06,5636,3528,60502,1107,9,710,120,1278,442,4635,1648,33386,539,1988
2021-06-07,5636,3528,59921,1045,13,688,111,1243,403,4573,2062,33617,600,1931
2021-06-08,5636,3528,59819,1045,10,674,95,1177,413,4573,2100,33971,763,1851
2021-06-09,5636,3528,59889,1045,15,656,114,1129,400,4573,2090,34016,748,1785
2021-06-10,5632,3526,59746,1034,7,640,99,1048,394,4560,2177,36067,637,1688
2021-06-11,5631,3529,59590,1035,14,608,102,1006,373,4564,1999,31141,664,1614
2021-06-12,5632,3530,59053,1035,5,609,99,995,368,4565,1941,30492,620,1604
2021-06-13,5632,3530,59027,1035,6,593,84,975,357,4565,1913,30883,629,1568
2021-06-14,5632,3530,59165,1035,9,563,71,981,337,4565,2174,35555,751,1544
2021-06-15,5632,3530,59136,1035,6,542,91,930,327,4565,2109,33803,759,1472
2021-06-16,5632,3530,58779,1035,5,514,67,874,319,4565,2104,33568,701,1388
2021-06-17,5632,3530,58652,1035,11,508,87,816,313,4565,2119,33429,701,1324
2021-06-18,5632,3525,58744,1035,12,491,79,780,315,4560,2069,32712,674,1271
2021-06-19,5632,3525,59156,1035,10,488,81,749,297,4560,1576,30689,419,1237
2021-06-20,5632,3525,59746,1035,5,478,72,777,287,4560,1595,31121,434,1255
2021-06-21,5632,3525,59049,1035,12,471,55,696,282,4560,2102,33758,712,1167
2021-06-22,5632,3525,59297,1035,5,460,62,673,274,4560,2212,36218,720,1133
2021-06-23,5632,3525,59079,1035,4,449,65,638,274,4560,2127,33983,703,1087
2021-06-24,5632,3525,59125,1035,8,420,54,646,274,4560,2133,33927,710,1066
2021-06-25,5632,3525,58708,1035,7,414,66,607,253,4560,2127,33012,510,1021
2021-06-26,5632,3525,58850,1035,2,410,70,594,258,4560,1973,25393,472,1004
2021-06-27,5632,3525,58528,1035,3,396,53,605,246,4560,1973,25485,498,1001
2021-06-28,5632,3525,59080,1035,3,377,60,603,241,4560,2136,33564,730,980
2021-06-29,5632,3525,58922,1035,7,374,56,562,237,4560,2320,36390,771,936
2021-06-30,5632,3525,58420,1035,6,360,74,538,227,4560,2206,33612,771,898
2021-07-01,5632,3525,58571,1035,4,349,68,503,209,4560,1677,25572,517,852
2021-07-02,5632,3525,58601,1035,5,333,45,497,213,4560,1646,25323,515,830
2021-07-03,5630,3523,58657,1035,3,314,43,498,203,4558,1660,25650,495,812
2021-07-04,5630,3523,58364,1035,2,309,41,501,198,4558,1699,25427,481,810
2021-07-05,5630,3523,58669,1039,4,302,54,498,198,4562,2255,34221,771,800
2021-07-06,5630,3523,59053,1039,3,288,52,502,192,4562,2371,36938,792,790
2021-07-07,5634,3525,59112,1050,0,279,58,501,184,4575,2253,34773,766,780
2021-07-08,5634,3525,58982,1050,6,275,46,448,180,4575,2255,34596,749,723
2021-07-09,5634,3529,58305,1059,2,272,54,429,174,4588,2100,31417,665,701
2021-07-10,5634,3529,58188,1059,3,275,54,439,172,4588,2044,31151,494,714
2021-07-11,5634,3529,58943,1059,3,279,30,422,160,4588,2101,31935,506,701
2021-07-12,5634,3529,59112,1059,5,259,40,421,165,4588,2190,34461,696,680
2021-07-13,5634,3529,59663,1059,5,249,56,413,158,4588,2263,35444,728,662
2021-07-14,5634,3529,59706,1059,1,237,54,408,152,4588,2365,37546,749,645
2021-07-15,5634,3529,59647,1059,4,224,43,402,151,4588,2231,35122,733,626
2021-07-16,5634,3528,59469,1065,4,211,37,384,146,4593,2102,32304,652,595
2021-07-17,5634,3528,58661,1065,4,209,49,393,135,4593,1717,31861,507,602
2021-07-18,5634,3528,58769,1065,3,210,38,397,130,4593,1693,31968,501,607
2021-07-19,5634,3528,59232,1065,2,205,48,381,133,4593,2220,34556,740,586
2021-07-20,5634,3528,59652,1065,8,213,38,357,110,4593,2230,35139,705,570
2021-07-21,5634,3528,59662,1065,2,214,48,351,121,4593,2331,37286,743,565
2021-07-22,5634,3528,59410,1065,1,209,42,336,118,4593,2194,34771,614,545
2021-07-23,5634,3523,59079,1062,3,196,41,315,116,4585,2106,31935,686,511
2021-07-24,5634,3523,59269,1062,2,188,39,321,116,4585,2090,32005,508,509
2021-07-25,5634,3523,59499,1062,6,191,42,337,111,4585,2058,32294,521,528
2021-07-26,5462,3366,59737,1062,4,189,41,325,118,4428,2244,34812,752,514
2021-07-27,5462,3366,59738,1062,7,185,45,309,117,4428,2272,35179,775,494
2021-07-28,5462,3370,60046,1069,3,188,50,311,118,4439,2373,37285,754,499
2021-07-29,5462,3370,59679,1069,3,183,46,313,119,4439,2209,34920,748,496
2021-07-30,5462,3370,59518,1069,2,171,45,316,123,4439,2087,31992,657,487
2021-07-31,5462,3370,59593,1069,1,160,43,315,114,4439,2057,31472,524,475
2021-08-01,5462,3370,59609,1069,0,162,36,320,110,4439,2066,31692,517,482
2021-08-02,5462,3370,59460,1069,5,168,30,319,109,4439,2110,32218,517,487
2021-08-03,5462,3370,59237,1069,1,170,30,327,106,4439,2139,32549,587,497
2021-08-04,5463,3371,59400,1069,8,176,69,341,103,4440,2363,37181,788,517
2021-08-05,5463,3371,59326,1069,4,173,67,372,101,4440,2229,34738,778,545
2021-08-06,5463,3371,58497,1069,5,177,62,339,103,4440,2098,31616,723,516
2021-08-07,5463,3371,59486,1069,1,175,64,354,97,4440,1725,26272,534,529
2021-08-08,5463,3371,59234,1069,4,172,49,342,94,4440,1727,26274,531,514
2021-08-09,5463,3366,58950,1070,6,179,51,369,95,4436,2223,34661,769,548
2021-08-10,5463,3366,59898,1070,10,187,65,380,102,4436,2235,35415,786,567
2021-08-11,5463,3366,59384,1070,14,207,91,386,104,4436,2346,37369,829,593
2021-08-12,5463,3366,59614,1070,4,204,74,415,99,4436,2194,35417,810,619
2021-08-13,5463,3365,59538,1067,10,214,71,426,99,4432,2093,32308,730,640
2021-08-14,5463,3365,59587,1067,6,222,73,409,103,4432,1734,26471,570,631
2021-08-15,5459,3363,59723,1056,7,226,59,420,104,4419,1725,26945,551,646
2021-08-16,5459,3363,59231,1056,8,242,72,462,118,4419,2237,35167,810,704
2021-08-17,5459,3363,59422,1056,4,248,78,480,119,4419,2228,35263,831,728
2021-08-18,5459,3363,59728,1056,15,255,84,517,114,4419,2298,37614,808,772
2021-08-19,5456,3363,59758,1056,11,269,76,555,122,4419,2192,35433,782,824
2021-08-20,5456,3371,59288,1055,7,272,76,600,126,4426,2065,32397,728,872
2021-08-21,4728,2680,52556,698,3,225,76,550,99,3378,1695,26676,531,775
2021-08-22,4728,2680,52638,698,4,240,61,595,102,3378,1677,26789,543,835
2021-08-23,4728,2680,52183,698,4,245,66,606,112,3378,1803,29245,638,851
2021-08-24,5456,3371,59466,1055,10,333,106,708,154,4426,2209,35545,783,1041
2021-08-25,5456,3371,59454,1055,21,350,88,737,166,4426,2269,37606,808,1087
2021-08-26,5450,3371,59437,1055,13,365,112,795,157,4426,2191,35125,780,1160
2021-08-27,5450,3366,59142,1034,13,381,95,808,160,4400,2072,32239,715,1189
2021-08-28,5450,3366,58564,1034,8,380,95,817,173,4400,2045,26189,536,1197
2021-08-29,5450,3366,59107,1034,6,394,78,829,170,4400,2046,26972,530,1223
2021-08-30,5450,3366,59463,1034,18,411,120,875,177,4400,2143,34894,694,1286
2021-08-31,5450,3366,59260,1055,22,434,140,903,194,4421,2207,35209,816,1337
2021-09-01,5450,3366,59417,1055,15,449,140,925,213,4421,2256,37509,836,1374
2021-09-02,5450,3366,58870,1055,21,468,127,933,221,4421,2171,34946,781,1401
2021-09-03,5450,3369,59268,1053,19,482,111,1002,222,4422,2006,32361,627,1484
2021-09-04,5450,3369,59146,1053,11,496,123,1036,228,4422,2013,26347,570,1532
2021-09-05,5450,3369,58834,1053,19,516,114,1053,238,4422,1991,26331,554,1569
2021-09-06,5450,3369,59461,1053,15,535,131,1073,241,4422,2017,27235,582,1608
2021-09-07,5450,3369,59014,1053,21,556,119,1147,242,4422,2227,34943,803,1703
2021-09-08,5450,3369,59156,1053,29,569,170,1222,258,4422,2324,37412,923,1791
2021-09-09,5454,3369,59222,1053,13,579,126,1240,263,4422,2200,35488,785,1819
2021-09-10,5454,3370,59338,1054,15,600,122,1310,272,4424,2103,33170,694,1910
2021-09-11,3072,1737,39787,1054,11,451,75,1112,169,2791,535,15464,52,1563
2021-09-12,5454,3370,59441,1054,13,631,122,1349,269,4424,2038,33213,538,1980
2021-09-13,5454,3370,59594,1054,27,657,122,1334,278,4424,2196,35612,715,1991
2021-09-14,5454,3370,59650,1054,21,677,152,1424,292,4424,2290,38289,764,2101
2021-09-15,5454,3370,59564,1054,17,678,112,1439,297,4424,2297,38168,887,2117
2021-09-16,5455,3370,59569,1054,23,684,120,1438,315,4424,2298,37859,818,2122
2021-09-17,5457,3373,59512,1056,17,672,119,1468,298,4429,2178,35258,834,2140
2021-09-18,4729,2680,52593,698,9,523,78,1337,219,3378,1723,27295,549,1860
2021-09-19,4729,2680,52641,698,10,537,63,1362,216,3378,1761,27524,533,1899
2021-09-20,5457,3373,59610,1056,25,708,147,1550,330,4429,2230,37781,886,2258
2021-09-21,5431,3349,59645,1056,19,728,150,1632,330,4405,2233,38018,882,2360
2021-09-22,5431,3349,59188,1056,18,732,143,1658,340,4405,2228,37950,904,2390
2021-09-23,5431,3349,59540,1056,24,743,177,1692,332,4405,2228,37764,667,2435
2021-09-24,5431,3351,59562,1058,13,740,115,1678,329,4409,2054,33061,763,2418
2021-09-25,4703,2656,52332,698,8,594,62,1456,230,3354,1703,27126,535,2050
2021-09-26,4703,2656,52815,698,9,611,58,1490,235,3354,1705,27535,543,2101
2021-09-27,5431,3351,59619,1058,19,751,145,1725,337,4409,2275,37516,861,2476
2021-09-28,5431,3351,59600,1058,19,758,176,1746,328,4409,2291,37839,886,2504
2021-09-29,5431,3351,59531,1058,19,763,150,1721,323,4409,2291,37856,918,2484
2021-09-30,4703,2656,52275,698,15,610,101,1528,235,3354,1967,31634,712,2138
2021-10-01,5431,3350,58215,1058,9,744,111,1714,318,4408,2175,33794,811,2458
2021-10-02,4703,2656,52664,698,9,605,68,1542,231,3354,1836,28916,580,2147
2021-10-03,4703,2656,52310,698,6,603,67,1544,232,3354,1845,28692,574,2147
2021-10-04,5431,3350,59120,1058,21,744,127,1782,323,4408,2294,36702,904,2526
2021-10-05,5431,3350,59551,1058,16,743,214,1806,319,4408,2350,38113,846,2549
2021-10-06,5431,3350,59593,1058,16,726,157,1851,317,4408,2348,38167,937,2577
2021-10-07,5431,3350,59515,1058,14,729,167,1864,312,4408,2320,37750,951,2593
2021-10-08,5431,3343,59307,1058,10,728,136,1827,309,4401,2246,35565,866,2555
2021-10-09,5431,3343,58774,1058,15,716,112,1775,314,4401,1861,28651,598,2491
2021-10-10,5431,3343,58804,1058,6,714,96,1794,310,4401,1835,28564,580,2508
2021-10-11,5431,3343,59528,1058,12,694,123,1805,308,4401,1851,29227,577,2499
2021-10-12,5431,3342,59428,1058,19,718,111,1778,326,4400,2297,37173,978,2496
2021-10-13,5431,3343,59709,1058,9,710,146,1796,331,4401,2361,38668,971,2506
2021-10-14,5431,3343,60116,1058,20,713,135,1753,342,4401,2347,38731,880,2466
2021-10-15,5392,3322,59803,1061,9,705,130,1767,340,4383,2261,36611,787,2472
2021-10-16,5392,3322,60039,1061,10,697,99,1724,331,4383,2217,35743,611,2421
2021-10-17,5392,3322,60006,1061,15,706,109,1738,336,4383,2233,35211,583,2444
2021-10-18,5392,3322,59965,1061,24,703,149,1721,345,4383,2333,37845,837,2424
2021-10-19,5379,3312,60208,1061,9,676,108,1731,348,4373,2389,38507,867,2407
2021-10-20,5379,3312,59966,1061,16,674,116,1667,335,4373,2356,38669,856,2341
2021-10-21,5379,3312,59154,1061,15,639,110,1677,307,4373,2272,35260,845,2316
2021-10-22,5379,3312,59211,1058,17,630,113,1624,310,4370,2127,33714,766,2254
2021-10-23,5379,3312,59187,1058,9,634,117,1578,309,4370,2103,32922,574,2212
2021-10-24,5379,3312,58823,1058,10,626,104,1568,308,4370,2109,32335,572,2194
2021-10-25,5379,3312,59360,1058,14,616,93,1527,294,4370,2320,37028,854,2143
2021-10-26,5379,3312,59820,1058,25,615,121,1489,296,4370,2376,38227,870,2104
2021-10-27,5379,3312,59780,1058,24,613,134,1488,301,4370,2360,38270,863,2101
2021-10-28,5379,3312,60075,1058,19,606,118,1478,291,4370,2370,38518,734,2084
2021-10-29,5379,3313,59626,1058,15,604,105,1447,292,4371,2196,34930,747,2051
2021-10-30,5379,3313,59692,1058,14,590,97,1420,294,4371,2150,28283,546,2010
2021-10-31,5379,3313,59188,1058,13,580,113,1443,283,4371,2120,27937,524,2023
2021-11-01,5379,3313,59737,1060,19,578,91,1435,270,4373,2241,36040,830,2013
2021-11-02,5379,3313,59765,1060,13,563,113,1496,266,4373,2285,37020,831,2059
2021-11-03,5379,3313,58792,1060,18,543,124,1411,274,4373,2273,36191,813,1954
2021-11-04,5379,3313,59707,1060,13,524,140,1408,270,4373,2279,37412,846,1932
2021-11-05,5379,3311,59485,1064,9,515,111,1408,259,4375,2177,34815,739,1923
2021-11-06,5379,3311,59712,1064,7,503,98,1409,252,4375,2179,34216,528,1912
2021-11-07,5379,3311,59401,1064,11,498,102,1422,249,4375,2133,34037,545,1920
2021-11-08,5379,3311,58060,1062,11,494,105,1374,252,4373,2303,35790,769,1868
2021-11-09,5379,3311,58996,1062,14,499,99,1373,259,4373,2332,36718,830,1872
2021-11-10,5379,3311,59736,1062,13,482,115,1289,255,4373,2316,37242,828,1771
2021-11-11,5379,3311,59039,1062,9,466,108,1321,254,4373,2233,34224,561,1787
2021-11-12,5379,3309,58488,1065,15,469,112,1310,247,4374,2206,33549,731,1779
2021-11-13,5379,3309,59429,1065,13,468,124,1311,243,4374,2165,33610,526,1779
2021-11-14,5379,3309,58775,1065,10,473,85,1321,251,4374,2184,32854,527,1794
2021-11-15,5379,3309,59198,1065,13,471,94,1287,239,4374,2269,36106,815,1758
2021-11-16,5379,3309,59748,1065,8,449,119,1318,239,4374,2309,36772,819,1767
2021-11-17,5379,3309,59529,1065,12,445,104,1297,238,4374,2311,36790,788,1742
2021-11-18,5379,3309,59834,1065,12,444,120,1286,241,4374,2292,36800,810,1730
2021-11-19,5378,3302,58788,1061,11,445,111,1258,245,4363,2206,34242,716,1703
2021-11-20,5377,3302,59009,1061,8,444,109,1238,246,4363,2178,34275,555,1682
2021-11-21,5377,3302,59069,1061,16,457,93,1251,243,4363,2162,33419,518,1708
2021-11-22,5377,3302,58743,1061,7,447,118,1245,237,4363,2293,36179,802,1692
2021-11-23,5377,3302,59395,1061,13,458,108,1222,235,4363,2349,37781,817,1680
2021-11-24,5377,3302,58081,1061,12,451,101,1204,223,4363,2339,36674,827,1655
2021-11-25,5377,3302,59216,1061,10,449,101,1128,230,4363,2339,37672,847,1577
2021-11-26,5377,3304,59207,1062,13,444,105,1137,231,4366,2232,35090,762,1581
2021-11-27,5377,3304,58479,1062,15,433,106,1160,230,4366,2092,31943,570,1593
2021-11-28,5377,3304,58511,1062,7,442,88,1150,232,4366,2101,30802,587,1592
2021-11-29,5377,3304,58863,1062,19,469,101,1163,238,4366,2261,36093,827,1632
2021-11-30,5377,3304,58900,1062,4,457,80,1185,229,4366,2408,35456,820,1642
2021-12-01,5377,3304,58837,1062,10,443,112,1179,227,4366,2378,35440,811,1622
2021-12-02,5377,3304,58777,1062,11,435,94,1141,229,4366,2364,37171,796,1576
2021-12-03,5340,3302,58685,1060,16,454,118,1086,232,4362,2303,34914,714,1540
2021-12-04,5340,3302,57767,1060,7,446,100,1090,231,4362,2214,31320,551,1536
2021-12-05,5340,3302,57892,1060,4,457,63,1126,234,4362,2146,29513,514,1583
2021-12-06,5340,3302,58961,1060,13,446,119,1115,229,4362,2399,36924,804,1561
2021-12-07,5340,3302,59626,1060,16,426,101,1122,230,4362,2452,38135,825,1548
2021-12-08,5340,3302,59098,1060,12,430,111,1096,226,4362,2484,37800,851,1526
2021-12-09,5340,3302,59615,1060,17,425,108,1094,220,4362,2486,38164,897,1519
2021-12-10,5340,3305,59461,1058,15,420,114,1090,217,4363,2350,35560,763,1510
2021-12-11,5340,3305,59276,1058,11,424,114,1108,213,4363,2258,32520,533,1532
2021-12-12,5340,3305,59123,1058,15,439,101,1123,208,4363,2250,32139,504,1562
2021-12-13,5340,3305,58467,1058,17,452,100,1086,229,4363,2409,36368,812,1538
2021-12-14,5340,3305,58597,1058,11,452,135,1066,234,4363,2438,37235,848,1518
2021-12-15,5348,3313,58317,1058,11,440,122,1096,238,4371,2451,36907,883,1536
2021-12-16,5348,3313,59029,1058,16,424,139,1123,223,4371,2451,37381,841,1547
2021-12-17,5352,3314,58815,1059,16,435,157,1138,225,4373,2356,34829,748,1573
2021-12-18,5352,3314,58077,1059,22,453,135,1132,238,4373,2223,31047,558,1585
2021-12-19,5352,3314,58330,1059,15,459,137,1195,241,4373,2193,30781,548,1654
2021-12-20,5352,3314,58950,955,12,468,148,1202,241,4269,2328,35019,799,1670
2021-12-21,5354,3316,58654,955,14,463,183,1247,249,4271,2358,34865,821,1710
2021-12-22,5354,3316,58542,955,14,455,209,1339,240,4271,2330,33636,774,1794
2021-12-23,5355,3316,58637,955,17,461,221,1337,246,4271,2240,33649,793,1798
2021-12-24,5355,3316,58487,955,10,451,147,1385,233,4271,2138,31902,787,1836
2021-12-25,5355,3316,58277,955,10,449,126,1434,230,4271,2028,28401,552,1883
2021-12-26,5355,3316,58338,955,34,476,386,1691,231,4271,2087,30867,550,2167
2021-12-27,5355,3316,58366,955,21,490,310,1921,240,4271,2143,31694,591,2411
2021-12-28,5355,3316,59095,955,20,476,371,2155,242,4271,2152,33004,553,2631
2021-12-29,5355,3316,59050,955,34,510,516,2489,247,4271,2199,33357,784,2999
2021-12-30,5356,3317,58253,954,32,533,526,2828,253,4271,2241,33024,780,3361
2021-12-31,5355,3316,57872,955,28,550,488,2788,272,4271,2227,32349,767,3338
2022-01-01,5355,3316,58182,955,25,574,444,3290,272,4271,2159,30142,553,3864
2022-01-02,5355,3316,57833,955,44,619,590,3654,298,4271,2225,32002,565,4273
2022-01-03,5355,3316,58122,955,29,645,700,4112,308,4271,2207,32587,552,4757
2022-01-04,5355,3312,59189,954,38,704,667,4616,336,4266,2269,34251,795,5320
2022-01-05,5356,3313,58663,954,48,739,806,5040,365,4267,2152,33889,816,5779
2022-01-06,5356,3313,58679,954,49,791,886,5339,370,4267,2326,35472,846,6130
2022-01-07,5355,3311,58431,950,36,865,921,5877,402,4261,2268,35297,821,6742
2022-01-08,5355,3311,58896,950,37,903,806,6276,403,4261,2116,32967,551,7179
2022-01-09,5355,3311,58789,950,21,914,819,6536,408,4261,2084,32738,529,7450
2022-01-10,5355,3311,58999,950,46,973,921,7114,428,4261,2172,35184,814,8087
2022-01-11,5355,3311,58800,950,40,1021,1041,7528,441,4261,2191,35024,826,8549
2022-01-12,5355,3311,59198,950,46,1029,1019,7947,463,4261,2211,35135,813,8976
2022-01-13,5355,3311,58775,950,44,1067,1038,8275,477,4261,2185,34373,821,9342
2022-01-14,5355,3312,58641,949,38,1096,999,8525,520,4261,2035,32070,752,9621
2022-01-15,5355,3312,59122,949,49,1121,1014,8865,544,4261,1998,32034,535,9986
2022-01-16,5355,3312,59121,949,39,1124,829,9135,560,4261,1961,31764,531,10259
2022-01-17,5355,3312,58585,949,44,1180,835,9408,577,4261,2066,33430,795,10588
2022-01-18,5355,3312,59140,949,54,1200,909,9387,590,4261,2107,34668,747,10587
2022-01-19,5355,3312,59251,949,56,1216,972,9527,589,4261,2109,34433,761,10743
2022-01-20,5355,3312,59182,949,37,1197,927,9522,606,4261,2103,34508,726,10719
2022-01-21,5364,3318,59321,954,47,1213,876,9437,630,4272,2005,32596,698,10650
2022-01-22,5364,3318,58998,954,31,1207,778,9465,624,4272,1999,31640,523,10672
2022-01-23,5364,3318,59169,954,41,1205,726,9630,620,4272,1952,31717,500,10835
2022-01-24,5364,3318,59338,954,45,1233,772,9788,638,4272,2094,34342,750,11021
2022-01-25,5364,3318,59256,954,41,1192,800,9541,643,4272,2125,34869,756,10733
2022-01-26,5369,3318,59075,954,25,1159,728,9395,618,4272,2133,34690,753,10554
2022-01-27,5369,3318,59015,954,39,1169,790,9276,640,4272,2135,34508,776,10445
2022-01-28,5369,3318,59357,953,45,1166,758,8899,636,4271,1988,33107,712,10065
2022-01-29,5369,3318,58466,953,33,1141,586,8766,597,4271,1955,31503,542,9907
2022-01-30,5369,3318,58445,953,27,1139,530,8827,587,4271,1950,31483,486,9966
2022-01-31,5369,3318,59259,953,41,1144,638,8807,596,4271,2057,34487,756,9951
2022-02-01,5369,3318,59246,953,32,1099,659,8603,569,4271,2116,35260,749,9702
2022-02-02,5369,3318,58938,953,33,1073,608,8317,578,4271,2113,35415,778,9390
2022-02-03,5370,3319,58544,953,31,1057,639,8090,550,4272,2135,34877,777,9147
2022-02-04,5370,3316,58587,955,38,1037,549,7792,531,4271,2124,34796,959,8829
2022-02-05,5370,3316,59068,955,30,1003,498,7589,522,4271,2163,34613,621,8592
2022-02-06,5370,3316,58633,955,25,1003,434,7585,522,4271,2109,34157,584,8588
2022-02-07,5370,3316,58857,955,28,1008,455,7492,537,4271,2167,35141,987,8500
2022-02-08,5370,3316,58216,955,30,976,565,7309,521,4271,2151,35042,969,8285
2022-02-09,5370,3316,57931,955,26,956,542,7149,519,4271,2175,34969,789,8105
2022-02-10,5370,3316,59044,955,30,920,494,6878,490,4271,2205,35972,790,7798
2022-02-11,5370,3331,58562,956,30,874,434,6616,466,4287,2212,35605,811,7490
2022-02-12,5370,3331,57723,956,23,846,394,6399,440,4287,2194,34046,606,7245
2022-02-13,5370,3331,58308,956,18,839,313,6490,429,4287,2107,33324,586,7329
2022-02-14,5370,3331,58969,956,17,805,395,6346,423,4287,2196,36301,762,7151
2022-02-15,5370,3331,59107,956,20,780,381,6151,421,4287,2212,36846,766,6931
2022-02-16,5370,3331,59312,956,21,767,425,5990,410,4287,2251,36893,775,6757
2022-02-17,5370,3334,58980,960,26,760,393,5799,398,4294,2158,36518,749,6559
2022-02-18,5370,3334,58884,960,15,730,350,5619,388,4294,2164,36500,616,6349
2022-02-19,5370,3334,58933,960,24,694,353,5511,373,4294,2093,33209,586,6205
2022-02-20,5370,3334,59022,960,19,680,292,5553,373,4294,2081,33561,593,6233
2022-02-21,5370,3334,58926,960,18,671,281,5504,361,4294,2108,33412,564,6175
2022-02-22,5370,3334,58500,960,9,659,340,5380,346,4294,2184,36135,751,6039
2022-02-23,5370,3334,58482,960,16,651,376,5300,346,4294,2220,36279,754,5951
2022-02-24,5370,3334,58542,960,37,627,308,5004,325,4294,2234,36573,758,5631
2022-02-25,5370,3324,59110,960,14,593,313,4830,312,4284,2176,37182,749,5423
2022-02-26,5370,3324,58858,960,13,581,300,4683,321,4284,2095,33821,594,5264
2022-02-27,5370,3324,58723,960,12,566,211,4669,302,4284,2103,33513,560,5235
2022-02-28,5370,3324,59195,960,15,570,247,4566,291,4284,2212,37156,740,5136
2022-03-01,5370,3324,59277,960,13,558,312,4429,293,4284,2125,35948,771,4987
2022-03-02,5370,3324,59277,960,14,547,341,4412,291,4284,2140,35998,792,4959
2022-03-03,5370,3324,58999,960,11,540,297,4324,261,4284,2265,31712,630,4864
2022-03-04,5370,3326,58902,961,16,513,251,4207,249,4287,2255,31242,649,4720
2022-03-05,5370,3326,58139,961,14,506,242,4108,236,4287,2154,27817,606,4614
2022-03-06,5370,3326,58487,961,16,508,229,4144,239,4287,2136,27856,614,4652
2022-03-07,5370,3326,59114,961,10,505,246,4143,245,4287,2248,31362,673,4648
2022-03-08,5370,3326,58268,961,12,492,268,4026,234,4287,2307,31032,691,4518
2022-03-09,5370,3326,58268,961,8,489,265,4060,230,4287,2317,31102,699,4549
2022-03-10,5370,3326,59256,961,8,467,249,3902,224,4287,2305,37683,827,4369
2022-03-11,5370,3322,57487,962,8,448,231,3810,216,4284,2276,35800,857,4258
2022-03-12,5370,3322,58580,962,10,440,217,3713,207,4284,2227,33756,693,4153
2022-03-13,5370,3322,58671,962,2,432,187,3722,194,4284,2205,33937,663,4154
2022-03-14,5363,3315,58315,962,15,435,246,3742,202,4277,2303,36476,789,4177